_ _ _ 2 _
_ _ 3 _ 1
_ _ 2 _ _
_ _ _ _ _
1 _ _ _ _