_ _ _ 3 _
2 _ 1 3 _
_ _ 3 _ 3
1 _ 5 _ 3
_ 2 _ _ _