_ _ _ _ _ _ _ _ 2
_ _ _ _ _ _ _ 3 _
_ _ _ 2 _ _ _ _ _
_ _ _ _ 3 _ _ _ _
_ _ _ _ _ 2 _ _ _
_ _ 1 _ _ _ _ _ _
_ _ _ _ _ _ 3 _ _
_ _ _ _ _ _ _ _ 2
1 _ _ _ _ _ _ _ _